k okay?
y why
r are
brb be right back
u you
pic picture
thx thanks!
18r later

k key
ur your
h hat
h have
u user
y wise
8 14 20 38 44 56 68 78 79 85 93 99 106 113 120
8 14 20 38 44 56 68 78 79 85 93 99 106 113 120 167
8 14 20 38 44 56 68 78 79 85 93 99 106 113 120 167 218
8 14 20 38 44 56 68 78 79 85 93 99 106 113 120 167 218 273
8 14 20 38 44 56 68 78 79 85 93 99 106 113 120 167 218 273 332
8 14 20 38 44 56 68 78 79 85 93 99 106 113 120 167 218 273 332 395
8 14 20 38 44 56 68 78 79 85 93 99 106 113 120 167 218 273 332 395 462
8 14 20 38 44 56 68 78 79 85 93 99 106 113 120 167 218 273 332 395 462 533
